新疆维吾尔自治区烟草公司乌鲁木齐市公司购买笼车项目中标公告	专用车
北京市通州区疾病预防控制中心北京市通州区疾控中心购置移动检验车及车载设备采购项目中标公告	专用车
沧州市公安交通警察支队执勤执法用车竞争性磋商中标公告沧州市公安交通警察支队执勤执法用车竞争性磋商中标公告	乘用车
南靖县医院特种专业用车货物类采购项目结果公告(包1)	专用车
莎车县农业技术推广中心农资、腐熟剂、展板横幅等采购项目（二次）中标结果公告	其他
内蒙古自治区综合疾病预防控制中心突发急性传染病队车载化建设公开招标结果公告	专用车
重庆市荣昌区生态环境局多功能抑尘车采购项目(20A00255)结果公告	环卫车
木垒县环卫清雪车采购项目 中标结果公告	环卫车
2020年中国地震局工程力学研究所科研设施运行维护项目：升降车购置（二次）中标公告	专用车
高密市交通运输局执法车采购项目成交公告	乘用车
中国共产党昌乐县纪律检查委员会机关公务用车采购项目成交公告	乘用车
福建经发-国际公开招标-1658-2041FJJF0007-医用智能轨道小车物流传输系统-结果公告	其他
宁波市公安局镇海分局交通警察大队关于钱江贝纳利BJ300J-5A巡航款标准版警用摩托车 6辆的在线询价成交结果公告	摩托车
福建省南平市人民政府办公室市直机关公务车辆定点维修保养服务服务类采购项目结果公告(包1)	维修
内乡县公安局警用边三轮摩托车采购项目单一来源成交公告	摩托车
南通市公务用车智能化平台升级改造项目[成交公告]	乘用车
机动车环境监管平台运行维护项目中标公告	其他
琼中黎族苗族自治县住房和城乡建设局-垃圾运输车-成交公告	环卫车
关于莎车县儿童福利院冬季服装及生活、学习用品采购项目的中标(成交)结果公告	其他
白璧镇左辅路国控点点位建设采购雾炮车、三轮冲洗车项目-中标结果公告	环卫车
渑池县交警执法停车场租赁服务项目成交公告	其他
南宁市出租汽车服务质量第三方考核成交公告	租赁
厦门市绿化中心草坪修剪车采购中标公告	环卫车
城市轨道交通车辆技术及供配电技术专业双师素质教师培养提升工程中标公告	其他
中国共产党苏州工业园区工作委员会宣传部关于北部市民中心工程车辆项目的成交公告	专用车
福建省龙岩华侨职业中专学校汽车运用与维修（智能新能源汽车）1+X证书制度考证实训设备货物类采购项目结果公告(包1)	维修
淮北市机关事务管理中心公务用车更新项目中标公告	乘用车
苏州市吴中区木渎镇人民政府关于警用摩托车竞争性谈判成交公告	摩托车
定陶汽车小镇基础设施建设PPP项目第三方审计服务采购项目中标公告	其他
浙江五石工程咨询有限公司关于机动车防治污染管理业务支撑综合服务项目的中标(成交)结果公告	其他
山东省潍坊市青州市城乡环卫中心经济开发区停车场租赁服务采购项目成交公告	其他
大同市云州区农业农村局2019年农村“厕所革命”整村推进吸粪车采购项目成交公告	环卫车
济宁市市直行政事业单位公务用车定点加油服务机构中标公告	其他
四川省凉山彝族自治州普格县卫生健康局关于国家能源集团“爱心红丝带”项目乡镇卫生院卫生应急摩托车采购项目成交公告	摩托车
丹棱县财政局丹棱县公务车辆保险服务采购项目中标公告	乘用车
北京市平谷区马昌营镇人民政府马昌营镇道路清扫电动车采购项目中标公告	新能源车
揭阳市公安局交警支队购置摩托车考场考试车辆项目成交公告	摩托车
广西禹捷项目管理有限公司靖西市公安局基层派出所一般执法执勤用车采购项目（BSZC2020-J1-250642-GXYJ）成交公告	乘用车
西畴县纪委执法执勤车询价采购项目成交公告	乘用车
当涂县市政管理所应急抢险车采购项目成交结果公告	专用车
北京市东城区环境卫生服务中心三所刘家窑桥东停车场租赁成交公告	其他
新疆巴音郭楞蒙古自治州阿尔金山国家级自然保护区管理局关于摩托车 2辆的在线询价成交结果公告	摩托车
汽车维修设备维护保养服务采购项目结果公告(包1)	维修
国家税务总局崇信县税务局越野车电子卖场采购项目成交公告	乘用车
玉树市扎西科街道办果青村扩建二手车交易市场项目的中标(成交)结果公告	其他
舟山市公共资源交易中心普陀区分中心关于公务车辆定点换胎服务资格入围的中标(成交)结果公告	维修
肃北县小型广场清扫车和地磅等配套设施项目中标公告	环卫车
深泽县党政机关社会化车辆定点租赁项目中标公告深泽县党政机关社会化车辆定点租赁项目中标公告	租赁
国家税务总局云阳县税务局越野车电子卖场采购项目成交公告	乘用车
江西省汇成招标代理有限公司关于江西省水上运动管理中心摩托艇设备采购项目（项目编号：JXHC2020-NC-JT005）竞争性谈判的成交结果公告	其他
国家税务总局苏州工业园区税务局小型客车电子卖场采购项目成交公告	公交车
重庆市市场监督管理局低速巡逻车采购(20A02103)结果公告	乘用车
西山区公务用车2021.1.1-2023.12.31车辆定点保险服务竞争性磋商入围成交公告	其他
湟源县和平乡小高陵村“乡村振兴”战略试点示范村建设项目卡丁车游乐场建设及卡丁车购置成交结果公告	专用车
[丰]丰县公安局警用摩托车及警用骑行装备采购项目公开招标中标结果公告[项目编号：丰采公（2020）XZXTD001]	摩托车
新疆中平信招标有限公司关于莎车县疾病预防控制中心冷藏冷冻库、温湿度监控仪项目的中标(成交)结果公告	其他
景县农业农村局粪污处理厂配套大型吸污车政府采购项目中标公告景县农业农村局粪污处理厂配套大型吸污车政府采购项目中标公告	专用车
2020年广东省云浮市公安局交警专用摩托车及装备采购项目成交公告	摩托车
广西科文招标有限公司南宁市机动车尾气超标车数据信息实时交换系统项目（一期）（NNZC2020-J3-990503-GXKW）成交结果公告	其他
宣城市宣州区种植业局公务用车采购项目成交结果公告	乘用车
国家税务总局郴州市税务局轿车电子卖场采购项目成交公告	乘用车
国家税务总局重庆市万盛经济技术开发区税务局小型客车电子卖场采购项目成交公告	公交车
中国邮政集团有限公司朝阳市分公司凌源市三家子乡县域仓储配送中心叉车采购项目中标公告	专用车
昌邑市公安局交通警察大队事故车辆鉴定服务项目成交公告	其他
山东科技大学青岛校区车辆租赁项目成交公告	租赁
准格尔旗铁路民航项目建设服务中心采购准格尔动车站站房及功能房亮化工程成交公告	其他
仙桃市城管局治安巡逻摩托车采购成交结果公告	摩托车
广州市公安局南沙区分局购置警用摩托车项目（重招）（CLF0120GZ09ZC24A）的中标（成交）结果公告	摩托车
平潭综合实验区社会事业局2020年校车采购项目货物类采购项目（重新招标）结果公告(包1)	乘用车
中华人民共和国深圳机场出入境边防检查站摩托艇维修项目中标公告	其他
合肥铁路工程学校城市轨道交通车辆控制及运营管理应用仿真实训系统中标（成交）结果公告	其他
松滋市公安局松滋市公安局摩托车采购项目中标(成交)结果公告	摩托车
交通执法执勤车辆更新购置（二次）中标结果公告	乘用车
怒江州疾病预防控制中心疫苗冷链车采购项目成交公告	专用车
江津区公安局交巡警支队车辆管理所定制办公家具（第二次）(20C01059)结果公告	其他
广西建设工程机电设备招标中心有限公司关于南宁市出租汽车服务质量第三方考核的中标(成交)结果公告	租赁
沈丘县人民检察院沈丘县检察院2019年中央及省级政法转移支付资金执法执勤用车-成交公告	乘用车
[省本级]江西省汇成招标代理有限公司关于江西省水上运动管理中心摩托艇设备采购项目（项目编号：JXHC2020-NC-JT005）竞争性谈判的成交结果公告	其他
盐源县润丰农业科技有限公司盐源县核桃初精深加工项目烤核桃车间内部装修项目成交公告	其他
秦皇岛经济技术开发区疾病预防控制中心疫苗转运车等采购项目成交公告秦皇岛经济技术开发区疾病预防控制中心疫苗转运车等采购项目成交公告	专用车
某单位摩托艇主机保养成交公告	其他
临漳县城市管理综合行政执法局购置挂桶封闭车项目公开招标中标公告	环卫车
购买微型消防站四轮消防摩托车中标公告	摩托车
库车市人民医院基层医疗机构“健康E站”建设项目中标(成交)结果公告	其他
岷县卫生健康局救护车购置采购项目中标公告	专用车
乌鲁木齐经济技术开发区（乌鲁木齐市头屯河区）火车西站片区管理委员会关于阻燃彩板房 1套的在线询价成交结果公告	其他
惠州市公安局交通警察支队警用摩托车采购项目的中标公告	摩托车
商丘市高铁站房东西两侧绿荫式停车场建设项目中标公告	其他
2021-2022年度鹤山市公务用车维修服务资格项目中标（成交）结果公告	维修
阿勒泰大草原4A级景区（阿禾公路精品旅游线路）建设项目（雪地摩托车及其配件）中标结果公告	摩托车
潮州市湘桥区公有物业管理中心潮州市市区智慧停车系统建设增补项目的中标公告	其他
曲靖市机动车遥感监测建设项目中标公告	其他
2021-2022年党政机关会议定点场所及公务用车车辆维修保养与加油定点场所政府采购项目（A包）定点入围中标公告2021-2022年党政机关会议定点场所及公务用车车辆维修保养与加油定点场所政府采购项目（A包）定点入围中标公告	维修
萌四路、防汛路北延（杨萌路-范阳河机动车道）交通设施工程项目成交结果公告	其他
三明市森林消防支队车辆维修、广告印刷定点采购项目结果公告	维修
启东飞鹤公交有限公司8米级、10米级纯电动新能源公交车采购项目（三标段）[成交公告]	新能源车
济南市生态环境局莱芜分局济南市生态环境局莱芜分局移动式机动车遥测系统（含专用车）及运维服务项目中标公告	专用车
Z1306842001512001高碑店市深度吸尘车采购项目结果公告	环卫车
奉节县公安执法执勤用车采购（第二次）结果公告	乘用车
警用大排量摩托车采购项目成交公告	摩托车
库车市人民医院购置医疗设备项目中标(成交)结果公告	其他
济南市公安局交通警察支队济南市公安局交通警察支队警用摩托车定位服务项目成交公告	摩托车
奉节县公安局执法执勤用车采购(20A00322)结果公告	乘用车
南通市市场监督管理局电瓶车库区域改造及大院北面修缮施工项目成交公告	其他
嵊泗县菜园镇人民政府压缩式垃圾车单一来源采购项目的中标(成交)结果公告	环卫车
湖南省生态环境监测中心大气颗粒物移动监测走航车运维公开招标中标公告成交公告	专用车
广州市广播电视台4K转播车项目（子项：4K转播车车体采购）中标公告	专用车
广西科文招标有限公司关于移动PCR实验室、车载CT采购（YLZC2020-G1-000630-GXKW）的中标结果公告	专用车
济南市历下区人民政府大明湖街道办事处（本级）济南市历下区人民政府大明湖街道办事处（本级）车辆维修保养服务项目成交公告	维修
中山市公安局交通警察支队警卫摩托车采购项目中标结果公告	摩托车
浙江欣斯路工程项目管理有限公司关于台州高速交警支队2021年1月-9月停车场租赁项目的中标(成交)结果公告	租赁
邯郸市生态环保局永年区分局重型柴油货车安装远程在线监控系统采购项目成交公告邯郸市生态环保局永年区分局重型柴油货车安装远程在线监控系统采购项目成交公告	其他
中华人民共和国温州机场出入境边防检查站温州机场出入境边防检查站公车定点维修（2020年）中标公告	维修
应城市城市管理执法局城区垃圾中转站压缩箱及运输车辆采购项目中标(成交)结果公告	环卫车
海岸警察总队（筹备组）购置HP1500型高速摩托艇项目中标公告	其他
山东省消防救援总队应急轻型越野车采购项目中标公告	乘用车
国家税务总局镇康县税务局小型客车电子卖场采购项目成交公告	公交车
江西国政招标咨询有限公司关于江西省南昌大学采购车辆工程专业工程认证设备项目（采购编号：JXGZ2020-11-1501-1）第二次竞争性磋商采购成交公告	其他
5132302020000819-1尕多乡人民政府更新公务用车采购项目（第二次）	乘用车
库车县残疾人联合会关于无障碍改造 1个的在线询价成交结果公告	其他
国家税务总局长春汽车经济技术开发区税务局纳税辅助服务外包采购项目中标公告	其他
台州天兴工程管理咨询有限公司关于台州市公安局交通警察局路口、路段智能斑马线、非机动车违法抓拍项目的中标结果公告	其他
宁波市国际招标有限公司关于宁波市公安局交通警察局警用摩托车定点维修项目（重发）的中标(成交)结果公告	维修
南岸区公安分局2020年度公务车辆采购(第二次)结果公告	乘用车
重庆市职业病防治院应急装备车辆升级改造(20C01504)结果公告	维修
广西华扬工程项目管理有限公司百合新区农贸市场暨扶贫车间厂房建设项目成交公告	其他
萌四路、防汛路北延（杨萌路-范阳河机动车道）交通设施工程中标公告	其他
银川市公安局交通警察支队飓风行动队建设摩托车棚项目公开招标中标公告	其他
福安市工业和信息化局政企直通车平台建设项目成交公告	其他
森林防火补助项目购置森林消防小型水车成交公告	专用车
华睿诚项目管理有限公司梧州市公安局交通警察支队人行道摩托车逆行抓拍及人脸抓拍设备（WZZC2020-J1-04468-HRCW）成交结果公告	其他
警用摩托车采购项目政府采购合同	摩托车
重庆市江津区中医院医疗设备和负压救护车采购(20A03387,20A03412,20A03478)结果公告	专用车
灵寿县交通运输局（事业）灵寿县正南线（正定灵寿界至南环）慢车道及绿化项目建设工程-设计公开招标中标公告灵寿县交通运输局（事业）灵寿县正南线（正定灵寿界至南环）慢车道及绿化项目建设工程-设计公开招标中标公告	其他
国网电动汽车服务湖北有限公司随州分公司国网随州供电公司2020年车联网平台及充电网络维护劳务服务项目中标公告	其他
汽车制造专业群虚拟仿真实训中心建设采购(20A03885)（BC202000301）结果公告	其他
军选民用车辆维修（二次）成交公告	维修
拉萨市人民医院负压救护车采购项目结果公告	专用车
广西国盛招标有限公司关于合山市人民医院医疗设备采购项目(负压病房及负压救护车车载抢救设备)（LBHSZC2020-J1-00002-GSZB）成交公告	专用车
昆山市交通运输局关于“两客一危”重点营运车辆风险防控技术研究及示范的成交公告	其他
河南省收费还贷高速公路管理有限公司洛阳分公司2020年车辆购置项目中标结果公告	乘用车
2020年同安交警大队车驾管“放管服”业务工作购买服务结果公告(包1)	其他
拜城县政府采购中心关于拜城县车辆消毒通道建设项目的中标(成交)结果公告	其他
金乡县公安局用摩托车及附件采购项目成交公告	摩托车
四川省消防救援总队总队模块储运箱及推车采购项目成交公告	消防车
北京市丰台区卫生健康委员会急救车及车载设备中标公告	专用车
上海市公安局杨浦分局杨浦分局摩托车多功能屏显成交公告	其他
廊坊市公安交通警察支队车辆维修维护项目公开招标中标公告廊坊市公安交通警察支队车辆维修维护项目公开招标中标公告	维修
启东飞鹤公交有限公司8米级、10米级纯电动新能源公交车采购项目（二标段）[成交公告]	新能源车
慈溪市公安局摩托车采购项目成交公告	摩托车
渝中区各街道群防群治电瓶巡逻车（第二次）(20A00324)结果公告	新能源车
南涧幸福路5G+智慧停车场系统项目政府购买服务中标公告	其他
西畴县纪委执法执勤车询价采购项目成交结果公告	乘用车
循化县消费扶贫特色产品展销体验中心河北区片扶贫车间项目成交公告	其他
北京2022年冬奥会和冬残奥会人员及车辆证件管理服务项目成交公告	其他
武汉市中心医院后湖院区停车场运营项目中标公告	其他
麦盖提县自然资源局关于车辆日常维修服务 1批的在线询价成交结果公告	维修
河北省唐山市中级人民法院囚车专用设备采购竞争性谈判中标公告	专用车
苏州市公安局苏州工业园区分局关于警用摩托车的中标公告	摩托车
.           无锡市公安局交警支队惠山大队采购14辆铁骑摩托车成交公告XCGZX2020-0396.           .	摩托车
莎车县恰热克镇人民政府关于恰热克镇生产母牛采购项目 12头的在线询价成交结果公告	其他
广西科文招标有限公司南宁市重型柴油车远程在线监控系统服务采购（NNZC2020-C3-990493-GXKW）成交结果公告	其他
龙华区多功能抑尘车运行维护服务项目中标结果公告	环卫车
鄂州市公安局交通警察支队铁骑摩托车配套装备采购项目成交结果公告	其他
中央民族大学附属中学红河州实验学校公务用车询价采购项目结果公告	乘用车
河南省鹤壁市中级人民法院3辆汽车-成交公告	乘用车
福建幼儿师范高等专科学校车辆租赁供应商入围招标采购项目结果公告(包1)	乘用车
江苏省吴中高新技术产业开发区（筹）管理委员会关于公车定点维修项目公开招标中标公告	维修
警用摩托车采购项目中标公告	摩托车
广西众鼎建设工程咨询有限公司贵港市中心城区互联网租赁自行车投放运营服务(GGZC2020-C3-051-GXZD)成交结果公告	其他
浙江五石工程咨询有限公司关于杭州市公安局交通警察支队交通工具购置——二轮警用摩托车采购项目的中标(成交)结果公告	摩托车
温泉县公安局购置执勤执法车辆采购项目      中标(成交)结果公告	乘用车
金华金开城市建设投资集团有限公司排涝救险车采购项目 重新招标的中标公告	专用车
盘山县公安局交通管理大队警用摩托车采购竞争性谈判成交结果公告	摩托车
龙岩人民医院车载CT货物类采购项目结果公告(包1)	其他
南涧一中5G+智慧停车场系统项目政府购买服务中标结果公示	其他
天津市河东区军队离休退休干部第二休养所轿车购置项目中标公告	乘用车
枣庄市公安局交通巡逻警察支队涉案车辆停车场租赁招标项目中标公告	其他
广西泽丰工程咨询有限公司关于垂直式垃圾压缩站成套设备及压缩式对接垃圾车采购（GLZC2020-G1-120061-GXZF）中标(成交)结果公告	环卫车
南京市公安局交通管理局车辆管理所机动车驾驶证科目二考试系统设备采购中标公告	其他
西宁市广播电视台融媒体转播车项目中标结果公告	专用车
2021年-2023年普洱市、思茅区行政事业单位车辆机动车保险服务入围招标采购项目	其他
Z1302002004542021唐山市路北区环境卫生管理中心2020-2023年车用液化天然气（LNG加注）采购招标结果公告	其他
重庆市交通运输综合行政执法总队车辆采购（20A02338）结果公告	乘用车
江西省佰驰工程咨询有限公司关于鹰潭市龙虎山风景名胜区市政运营智能无人清扫车采购项目（项目编号：JXBCYT2020-11-18012）竞争性磋商成交结果公告	环卫车
[成交公告]连云港市海州区环境卫生管理处：干扫吸尘车中标公告	环卫车
警务机动大队警用摩托车维修保养技术服务采购项目结果公告(包1)	维修
北海市政府采购中心关于北海市机关后勤服务中心2020-2021年度公务车辆维修和保养服务（BHZC2020-C3-000045-CGZX）竞争性磋商成交结果公告	其他
临汾市第二中学校智能车牌识别系统购置项目成交公告	其他
广东省惠州市石油产品质量监督检验中心快速检测车租车服务采购项目成交公告	租赁
南昌市青山湖风景区管理处职工意外伤害险和非机动车第三者险购买服务单一来源中标公告	其他
江宁高职校汽车仿真实训及营销软件项目成交公告	其他
山东省泰安市肥城市石横镇特勤消防站消防车采购项目中标公告	消防车
国家税务总局郴州市税务局越野车电子卖场采购项目成交公告	乘用车
关于莎车县高级学校广告制作采购项目的中标(成交)结果公告	其他
广西众鑫工程项目管理有限公司新能源汽车租赁服务（项目编号：CZZC2021-C3-00004-GXZX）成交结果公告	租赁
苏州工业园区斜塘街道办事处关于斜塘街道道路保洁（C标段车坊片）的中标结果公告	其他
国家税务总局浙江省税务局小型客车电子卖场采购项目成交公告	公交车
汾阳市公安局交通警察大队警用摩托车采购项目成交公告	摩托车
西藏自治区环境信息中心西藏自治区机动车管理信息平台中标公告	其他
卡迪诺科技（北京）有限公司新建精密加工车间、厂房项目中标公告	其他
徐州市泉山区应急管理局通信指挥车项目询价成交结果公告[项目编号：徐采询(2020)049]	专用车
东莞市公安局黄江分局辅警大队购置警用摩托车和警用开蓬车采购项目成交公告	摩托车
[分宜县]分宜县亚林中心机动车拍卖项目网络电子竞价成交公告	乘用车
关于陕西省汽车客运站人证核验系统数据接口对接平台及站务系统改造项目的采购结果公告	其他
甘肃畜牧工程职业技术学院汽车实训中心配套建设工程项目成交公告	其他
南通市公安局水上警察支队跨骑式摩托艇采购项目[成交公告]	其他
黄岩区应急能力提升工程-2.5吨水罐消防车采购非政府采购结果公告	消防车
巩义市交运汽车综合性能检测有限公司设备采购项目询价结果公告	其他
黄冈市环卫局生产特种车辆维修资格项目中标(成交)结果公告	维修
广西金米工程项目管理有限公司负压监护型救护车(项目编号：BSZC2020-J1-220392-GXJM）成交结果公告	专用车
警用大排量摩托车采购项目政府采购合同	摩托车
大田县前坪乡政府垃圾压缩车采购货物类采购项目结果公告(包1)	环卫车
某部车辆及工程机械轮胎采购项目2020-JLNSGB-W3003竞争性谈判成交公告	其他
襄阳市公安局采购警用电动摩托车项目中标(成交)结果公告	摩托车
江西合盛工程管理咨询有限公司关于上饶市广丰区城市管道燃气有限公司广丰天然气管网LNG运输车辆租赁项目（项目编号：JXHSCG2020077）的竞争性谈判采购成交公告	专用车
沈阳市环境保护工程设计研究院有限公司沈阳城市固废综合利用绿色环保产业园3#污泥车间除臭塔基础工程中标公告	环卫车
昆山蔚洲房产开发有限公司关于周市镇惠安路南侧拆迁地块停车位等改造工程项目的公开招标中标公告	其他
上海市消防救援总队2020年静安支队消防车辆采购项目中标公告	消防车
九龙坡区市政设施维护管理处所需2020年停车划线及标志、标牌安装工程项目中标(成交)结果公告	其他
应急管理部森林消防局昆明航空救援支队昆明航空救援支队应急车辆定点维修项目成交公告	维修
广元市中心医院分院产科移动洗婴车、核医学铅屏风等防护用品采购项目成交公告	专用车
研发电动雪地摩托车服务项目成交结果公告	摩托车
江苏省淮安体育运动学校2021年车辆租赁服务采购项目成交公告	租赁
重庆市南岸区各街镇卫生院救护车采购(20A00398,20A00399,20A00417,20A00385,20A00411,20A00413)结果公告	专用车
惠州市公安局惠城区分局警用摩托车采购项目（采购项目编号：HMD2020-40）的中标、成交公告	摩托车
新疆方通招标关于莎车县维吾尔医医院远程心电实时监护技术项目、网络布线、办公耗材  预中标公告	其他
广西科文招标有限公司关于南宁市机动车和非道路移动机械尾气检测设备采购（NNZC2020-J1-990496-GXKW）成交公告	其他
鹤庆县民政局殡仪服务特种专业技术用车采购项目成交结果公告	专用车
武昌湖水产品冷链物流建设项目（二次）(四包：采购叉车1辆)成交结果公告	专用车
消防车辆及装备器材采购公开招标中标公告消防车辆及装备器材采购公开招标中标公告	消防车
中国共产党洛阳市纪律检查委员会执法执勤车辆采购项目变更中标公告	乘用车
虎溪街道购置一台车辆成交公告	乘用车
洛阳市交通运输综合行政执法支队新能源业务用车采购中标公告	新能源车
国家税务总局厦门市税务局第二稽查局小型客车电子卖场采购项目成交公告	乘用车
全市公务用车加油集中定点采购项目（三次）成交结果公告全市公务用车加油集中定点采购项目（三次）成交结果公告	其他
青岛市妇女儿童医院大孔径CT医疗车成交公告	其他
东莞市公安局交通警察支队警卫摩托车骑行防护装备及警卫摩托车胎压监测器成交公告	摩托车
召陵区检察院执法执勤车采购项目成交公告	乘用车
陕西省消防救援总队特种攻坚车辆装备采购项目（高机动器材运输车）中标公告	消防车
（佛山市公安局）佛山市公安局交警支队2020年度购买大功率警卫摩托车项目-中标公告	摩托车
滨州市公安局交通警察支队警用摩托车采购中标公告	摩托车
内蒙古达拉特经济开发区管理委员会街道清洗清扫车结果公告	环卫车
高邑县消防救援大队执勤车辆维修项目成交公告	维修
大庆市城市管理事业发展中心河湖广场中心采购洗扫车项目成交公告	环卫车
乐业县原畜牧局小区后至地震局停车场建设工程的成交结果公告	其他
新疆久诺工程项目管理有限公司关于莎车县商工局十四五规划编制采购项目（二次）的中标(成交)结果公告	其他
中牟汽车产业集聚区辅民路、文锦北路、牟轩街雨污水工程中标结果公示	环卫车
养护段采购2020公路养护及应急抢险设备（清洗车）(20A03474)结果公告	环卫车
国家税务总局宝兴县税务局轿车电子卖场采购项目成交公告	乘用车
南川区蓝天环保工程有限公司医疗废物收运车(20A0000)结果公告	专用车
哈尔滨职业技术学院_2020年部门预算财政专户资金-通勤车租赁服务和维修工程监理服务等采购_HC[2020]1143中标公告	乘用车
北京市公安局东城分局电动自行车项目成交公告	其他
国家税务总局曲阳县税务局轿车电子卖场采购项目成交公告	乘用车
鸟岛分局、沙岛分局、二郎剑分局、海事局实施健身器材、电瓶巡逻车等物品采购成交结果公告	新能源车
新疆谊诚工程项目管理咨询有限公司关于莎车县第四中学办公、卫生、校园文化及厨房设备采购项目的中标(成交)结果公告	其他
新疆天佑铭华项目管理有限公司关于莎车县2018年度增减挂资金项目全过程合规性跟踪监管中介服务采购的中标(成交)结果公告	其他
云南省消防救援总队2019年度消防车辆采购项目（第三批）中标结果公告	消防车
厦门华沧-竞争性谈判-2020-HCJZ-SH1726-车模教学场地建设及安全设施提升项目的结果公告	其他
广东省特种证件制作中心2020-20车牌车间半成品生产线项目中标公告	其他
济南市历下区动物疫病预防与控制中心济南市历下区动物疫病预防与控制中心机动车保险服务项目成交公告	其他
国家税务总局广州市天河区税务局综合办公楼和车陂、石牌、沙太路、天河南、天河东等办公区物业服务项目（GPCGD20C500FG133F）中标公告	其他
中国人寿财产保险股份有限安徽省分公司中国人寿财产保险股份有限公司安徽省分公司2020-2022年度故障车辆道路救援服务供应商采购中标公告	其他
昭苏县察汗乌苏蒙古民族乡人民政府采购巡逻车项目的中标(成交)结果公告	乘用车
淮安市淮安区动物卫生监督所吸污车中标公告	环卫车
中国民航大学对外租赁车辆服务项目中标公告	租赁
Z13112320010220012020年武强县农村“厕所革命”整村推进化粪池污水处理车采购项目结果公告	环卫车
广州市公安局白云区分局车辆租赁服务采购项目(CZ2020-1763)中标结果公告	租赁
迁西县财政局2021年迁西县行政事业单位办公车辆保险供应商采购公开招标中标公告迁西县财政局2021年迁西县行政事业单位办公车辆保险供应商采购公开招标中标公告	其他
昆明市公安局国家经济技术开发区分局购买执法执勤电瓶车和摩托车采购公开招标中标公告	摩托车
前郭尔罗斯蒙古族自治县公安局交通管理警察大队前郭县公安局交通警察大队警用摩托车采购项目中标公告	摩托车
赣州市南北招标代理有限公司关于江西省赣州市南康区城市管理局报废摩托车处理服务公司采购项目（采购项目编号：GZNB2020-NK-J002-1）竞争性谈判的成交结果公告	其他
济南大学城实验高级中学公务用车租赁服务三次招标成交公告	租赁
龙洲湾和鱼洞片区智慧停车场管理系统及停车场视频监控系统建设项目项目中标(成交)结果公告	其他
2021-2023年度台山市市直公务用车租赁服务资格项目中标结果公告	租赁
蚌埠市紧急救援中心采购负压救护车项目中标结果公告项目编号：BB2020ZFCGZ4201	专用车
巧家县公安局警用两轮摩托车采购项目成交公告	摩托车
塔城世纪星工程咨询有限公司关于塔城地区公安消防支队车辆保险项目的中标(成交)结果公告	消防车
莎车县托木吾斯塘镇中心双语幼儿园关于校园文化 1批的在线询价成交结果公告	其他
长春正有新能源投资建设集团长春国际汽车城天然气市政配套工程项目-勘察中标公告	其他
绩溪县应急物资保障体系建设（疫苗冷藏车）采购成交公告	专用车
公物投资-公开招标-GT2020-SH140D-厦门大队摩托艇定点维修服务-中标公告	其他
四川省机关事务管理局机关SCZC338301_20200049客车网上竞价项目成交公告	公交车
固原市消防救援支队2020年车辆保险采购项目中标公告	其他
大连市公安局交通警察支队警用摩托车保险服务项目中标公告	其他
乐东黎族自治县卫生健康委员会-乐东县卫健委涉水车采购项目-成交公告	其他
唐山市路北区环境卫生管理中心2020-2023年车用液化天然气（LNG加注）采购招标（三次）中标公告唐山市路北区环境卫生管理中心2020-2023年车用液化天然气（LNG加注）采购招标（三次）中标公告	其他
宁波市公安局大榭开发区分局关于摩托车 4辆的在线询价成交结果公告	摩托车
乌鲁木齐经济技术开发区（头屯河区）火车西站片区管委会秀丽社区党建示范点提升改造项目成交公告	其他
国家税务总局芦山县税务局轿车电子卖场采购项目成交公告	乘用车
蒙阴县智华职业中等专业学校新校建设项目汽车运用与维修专业教学实训基地建设项目中标公告	维修
江苏省泗洪中等专业学校汽车维修工具设备软件采购项目结果公告	其他
四川省巴中市恩阳区机关事务服务中心机关事务服务中心应急、通信、抢险等车辆维修和保养服务（第二次）公开招标中标公告	维修
三明市消防救援支队白沙路特勤站执勤器材库及车库修缮工程结果公告	其他
伊犁州巩留县应急管理局消防车辆装备项目成交结果公告	消防车
石家庄市鹿泉区环境卫生管护中心餐厨垃圾车购置项目中标公告石家庄市鹿泉区环境卫生管护中心餐厨垃圾车购置项目中标公告	环卫车
新疆雅新投资有限公司车辆采购项目中标公告	乘用车
中华人民共和国第一届职业技能大赛《轨道车辆技术》项目竞赛设备采购项目(项目编号：0877-20GZTP01H704)成交结果公告	其他
泽库县卫生健康局标准化卫生室家庭医生服务摩托车采购项目中标结果公告	摩托车
洛阳市科技馆车棚建造项目成交结果公告	其他
